26 26 26 26 26 26 26 26 27 26 26 26 26 26 26 26 26 26 26 26 26 26 26 26 26 26 26 27 26 26 26 26 26 26 26 26 36 34 34 34 34 34 34 34 34 34 34 34 34 37
26 26 26 27 26 26 26 26 26 26 26 26 26 26 26 26 26 26 27 26 26 26 26 26 27 26 26 26 26 26 27 26 26 26 26 26 32 10 10 10 11 10 11 10 10 10 10 10 10 31
26 26 26 26 26 26 26 26 26 26 27 26 26 26 26 26 27 26 26 26 26 26 26 26 26 26 26 26 26 26 26 26 26 26 26 27 32 10 11 10 10 10 10 10 11 10 10 11 10 31
26 26 36 34 34 34 34 34 34 34 34 34 34 34 34 34 34 34 34 34 34 34 34 34 34 34 34 34 34 34 34 34 34 34 37 26 32 10 10 10 10 10 10 10 10 10 10 10 10 31
26 26 32 10 10 10 10 10 10 10 10 10 10 10 10 10 10 10 10 10 10 10 10 10 10 10 10 10 10 10 10 10 10 10 31 26 32 10 10 10 10 11 10 10 10 10 10 11 10 31
26 26 32 10 11 10 10 10 10 10 10 10 10 10 10 10 10 10 10 10 11 10 10 10 10 10 10 10 10 10 10 10 10 10 33 37 38 30 11 10 10 10 10 10 10 11 10 10 10 31
26 26 32 10 10 10 42 10 11 10 42 10 10 11 10 10 10 10 10 10 10 10 10 10 11 10 10 10 10 10 10 10 11 10 10 31 26 32 10 10 11 10 10 10 10 10 10 11 10 31
26 26 32 10 10 10 11 10 42 42 10 11 10 10 10 10 10 10 10 10 10 10 10 10 10 10 10 10 10 10 11 10 10 10 10 33 37 38 30 10 11 10 10 10 11 10 10 10 28 39
26 26 32 10 10 10 42 10 10 10 10 10 10 10 10 10 11 10 10 10 10 10 10 10 10 10 10 10 10 10 10 10 10 10 10 10 31 26 38 30 10 10 10 10 10 10 10 10 31 26
26 26 32 10 10 10 10 10 10 42 10 10 10 10 10 10 10 10 10 10 10 10 10 10 10 10 10 10 11 10 10 10 10 10 10 10 33 37 26 38 29 29 29 29 41 29 29 29 39 26
26 26 32 10 10 10 10 10 10 10 10 10 10 10 10 10 10 10 10 11 10 11 10 10 10 10 10 10 10 10 10 10 10 10 10 10 10 31 26 26 26 26 26 26 41 26 26 26 26 26
26 26 32 10 10 10 10 10 11 10 10 10 10 10 10 10 10 10 10 10 10 10 10 10 10 10 10 10 10 10 10 10 10 10 10 10 10 33 37 26 26 26 26 26 41 26 26 26 27 26
26 26 32 10 10 10 10 10 10 10 10 10 10 10 10 10 10 10 10 10 10 10 10 10 10 10 10 10 10 10 10 10 10 10 10 10 10 41 41 41 41 41 41 41 41 26 26 26 26 26
27 26 32 10 10 10 10 10 10 10 10 10 10 10 10 10 10 10 10 10 10 10 10 10 10 10 10 10 10 10 10 10 11 10 10 10 28 29 39 26 26 26 26 26 26 26 27 26 26 27
26 26 32 10 11 10 10 10 10 10 11 10 10 10 11 10 10 10 10 10 10 10 10 10 10 10 10 10 10 10 10 10 10 10 10 10 31 26 26 26 26 26 26 26 26 26 26 26 26 26
26 26 32 10 10 10 10 10 10 10 10 10 10 10 10 10 10 10 10 10 10 10 10 10 10 42 42 10 10 10 10 11 10 42 10 10 33 34 37 27 26 26 26 26 26 26 26 26 26 26
26 26 32 10 10 10 10 10 42 10 10 10 10 10 10 10 10 10 10 10 10 10 10 10 10 11 42 42 10 10 10 10 10 10 10 10 10 10 31 26 26 26 27 26 27 26 26 27 26 26
26 27 32 10 10 10 10 10 10 10 10 10 10 10 11 10 11 10 10 10 11 10 10 10 10 10 10 42 10 10 10 10 10 10 10 10 10 10 31 26 26 26 26 26 26 26 26 26 26 26
26 26 32 10 10 10 10 10 10 10 10 10 10 10 10 10 10 10 10 10 10 10 10 10 10 10 42 42 10 10 10 10 10 11 10 10 10 10 31 26 26 26 27 26 26 26 26 26 26 26
26 26 32 10 10 42 10 10 10 10 10 10 10 10 10 10 10 10 10 10 10 10 10 10 10 10 42 42 10 10 10 11 10 10 10 10 10 10 31 26 27 26 26 26 26 26 26 26 26 27
26 26 32 11 10 10 10 10 10 42 10 11 10 10 10 10 10 10 10 10 10 10 10 10 10 42 42 42 10 10 10 10 10 10 10 10 10 10 33 34 34 34 34 34 34 37 26 26 26 26
27 26 32 10 10 10 10 10 42 10 10 10 10 10 10 10 42 42 10 10 10 10 10 10 10 42 42 42 10 10 10 10 10 10 10 42 10 10 10 10 10 10 10 10 10 31 26 26 26 26
26 26 32 10 10 42 10 10 10 10 10 10 10 10 10 10 42 42 10 10 10 10 10 10 42 42 10 10 10 10 10 10 10 10 10 10 10 10 10 10 10 10 10 10 10 31 26 26 26 26
26 26 32 10 10 10 10 10 10 10 10 10 10 10 10 10 10 10 42 10 10 10 10 11 42 42 42 10 11 10 10 11 10 10 10 10 10 10 10 10 10 10 11 10 10 31 26 27 26 26
26 26 32 10 10 10 10 10 10 10 10 10 10 11 10 10 10 10 42 42 10 10 10 10 10 10 10 10 10 10 10 10 10 10 10 10 10 42 10 10 10 10 10 10 10 31 26 26 26 26
27 26 32 10 10 11 10 10 10 10 10 10 10 10 10 10 10 10 10 42 10 10 10 10 42 10 10 10 10 10 10 10 10 10 10 10 10 11 10 10 10 10 10 10 10 31 26 26 27 26
26 26 32 10 10 10 42 10 10 10 10 11 10 10 10 10 10 10 10 11 10 10 10 10 10 10 10 10 10 10 10 10 10 10 10 10 10 10 10 10 11 10 10 10 10 31 26 26 26 26
26 26 32 10 10 10 10 10 10 10 10 10 10 10 10 10 11 10 10 10 42 10 10 10 10 10 10 10 10 10 10 10 10 10 10 10 10 10 10 10 10 10 10 10 10 31 27 26 26 26
26 27 32 10 10 10 10 10 10 10 11 10 10 10 10 10 10 10 10 42 42 42 10 10 10 10 10 10 11 10 10 11 10 10 10 10 10 10 42 10 10 10 10 10 10 31 26 26 27 26
26 26 32 10 10 10 10 10 10 10 10 10 10 10 10 10 10 10 10 42 42 42 10 10 10 10 10 10 10 10 10 10 10 10 10 10 10 10 10 10 10 10 10 10 10 31 26 26 26 26
26 26 32 10 10 10 10 10 10 10 10 10 10 10 10 10 10 10 10 42 42 42 10 10 10 10 10 10 11 10 10 10 10 10 10 10 10 10 10 10 10 10 11 10 10 31 26 26 26 26
26 26 32 10 10 10 10 10 10 10 10 10 10 10 10 10 10 10 10 42 42 42 10 10 10 10 10 10 10 10 10 10 10 10 10 42 10 10 10 10 10 10 10 10 10 31 26 26 26 26
26 26 32 10 10 10 10 11 42 10 10 10 10 10 10 10 10 42 42 42 42 42 42 42 10 10 10 10 10 10 10 11 11 10 10 10 10 10 10 10 11 10 10 11 10 31 26 27 26 26
27 26 32 10 10 10 10 10 10 10 10 42 10 10 10 10 10 42 42 42 42 42 42 42 10 10 10 10 10 10 42 10 10 10 11 10 10 42 42 10 10 10 10 10 10 31 26 26 26 26
26 26 32 10 11 10 10 10 10 10 10 10 10 10 10 10 10 42 42 42 10 42 42 42 11 10 10 10 10 10 10 10 10 10 10 10 10 10 10 10 10 10 10 10 10 31 26 26 27 26
26 26 32 10 10 10 10 10 10 10 11 10 10 10 10 10 10 10 11 10 10 10 10 10 10 10 10 10 10 11 10 10 10 10 10 10 10 10 10 10 10 10 10 11 10 31 26 26 26 26
26 27 32 10 10 10 10 10 10 10 10 10 10 10 10 10 10 10 10 10 10 10 10 10 10 10 10 10 10 10 10 10 10 10 10 10 11 10 10 10 11 10 10 10 10 31 26 26 26 26
26 26 32 10 10 10 10 10 10 10 10 10 10 11 10 10 10 10 10 10 10 10 10 11 10 10 10 10 10 10 10 10 10 42 10 10 10 10 10 10 10 10 10 10 10 31 26 26 26 26
26 26 32 10 42 10 10 11 10 10 10 10 10 10 10 10 10 10 10 10 10 10 10 10 10 10 10 10 10 10 10 10 10 42 10 42 10 10 10 10 10 10 10 10 10 31 27 26 27 26
26 26 32 10 10 10 10 10 10 10 10 10 10 10 10 10 10 10 10 10 10 10 10 10 10 10 10 10 10 10 10 42 10 10 10 10 10 10 10 11 10 10 10 10 10 31 26 26 26 26
26 26 32 10 10 10 10 10 10 10 10 10 10 10 10 10 10 10 10 10 10 10 10 10 10 10 10 10 10 10 10 10 10 42 10 10 10 10 10 10 10 10 10 10 10 31 26 26 26 26
26 26 32 10 10 10 10 10 10 10 10 10 10 10 10 11 10 10 10 10 10 10 10 11 10 10 10 10 10 11 10 10 10 10 10 42 10 10 10 10 10 10 10 11 10 31 27 26 26 26
26 27 32 10 11 11 10 10 10 10 10 10 10 10 10 10 10 10 10 10 10 10 10 10 10 10 10 10 10 10 10 10 42 10 42 10 10 11 10 10 10 10 10 10 10 31 26 26 26 26
26 26 32 10 10 10 10 10 10 10 10 10 10 10 10 10 10 10 10 10 10 10 10 10 10 10 11 10 10 10 10 10 10 10 10 10 10 10 10 10 10 10 10 10 10 31 26 26 27 26
26 26 32 10 10 10 10 10 10 10 10 10 10 11 10 10 10 10 10 10 10 10 10 10 10 10 10 11 10 11 10 10 10 42 10 10 10 10 10 10 10 11 10 10 10 31 26 26 26 26
27 26 32 10 10 10 10 10 10 10 10 10 10 10 10 10 10 10 10 10 10 10 10 10 10 10 10 10 10 10 10 10 10 10 10 10 10 10 10 10 10 10 10 10 10 31 26 27 26 26
26 26 38 29 29 29 29 29 29 29 29 29 29 29 29 29 29 29 29 29 29 29 29 29 29 29 29 29 29 29 29 29 29 29 29 29 29 29 29 29 29 29 29 29 29 39 26 26 26 26
26 26 27 26 26 26 27 26 26 26 26 26 26 27 26 26 27 26 26 26 26 26 26 26 27 26 26 26 26 26 26 26 26 26 26 27 26 27 26 26 26 26 26 27 26 26 26 26 27 26
26 26 26 27 26 26 26 26 26 26 26 27 26 26 26 26 26 27 26 26 26 26 26 26 26 26 26 27 26 26 27 26 26 27 26 26 26 26 26 27 27 26 26 26 26 26 26 26 26 26
26 26 26 26 27 26 26 26 26 26 26 26 26 26 27 26 26 26 26 26 26 27 26 26 26 26 26 26 26 27 26 26 26 26 26 26 26 27 26 26 26 26 26 26 27 26 26 26 26 26
