42 42 42 42 42 42 42 42 42 42 42 42 42 42 42 42 42 42 42 42 42 42 42 42 42 42 42 42 42 42 42 42 42 42 42 42 42 42 42 42 42 42 42 42 42 42 42 42 42 42
42 42 42 42 42 42 42 42 42 42 42 42 42 42 42 42 42 42 42 42 42 42 42 42 42 42 42 42 42 42 42 42 42 42 42 42 42 42 42 42 42 42 42 42 42 42 42 42 42 42
42 42 42 42 42 42 42 42 42 42 42 42 42 42 42 42 42 42 42 42 42 42 42 42 42 42 42 42 42 42 42 42 42 42 42 42 42 42 42 42 42 42 42 42 42 42 42 42 42 42
42 42 42 42 10 10 42 42 42 42 42 42 42 42 42 42 42 42 42 42 42 42 10 10 10 10 10 10 10 10 10 10 10 10 10 10 42 42 42 10 10 10 10 10 10 10 10 10 42 42
42 42 42 42 10 10 10 10 10 10 10 10 42 42 42 42 42 42 42 42 42 10 10 10 10 10 10 10 10 10 10 10 10 10 10 10 42 42 42 10 10 10 10 10 10 10 10 42 42 42
42 42 42 42 10 10 10 10 10 10 10 10 42 42 42 42 42 42 42 42 10 10 10 10 10 10 10 10 10 10 10 10 10 10 10 10 42 42 42 10 10 10 10 10 10 10 10 10 42 42
42 42 42 42 10 10 10 10 10 10 10 10 10 10 10 10 10 10 10 10 10 10 10 10 10 10 10 10 10 10 10 10 10 10 10 10 42 42 42 10 10 10 10 10 10 10 10 10 42 42
42 42 42 42 42 42 42 42 42 42 42 42 10 10 10 10 10 10 10 10 10 10 10 10 10 10 10 10 10 10 10 10 11 10 10 10 42 42 42 10 10 10 10 10 10 10 10 10 42 42
42 42 42 42 42 42 42 42 42 42 42 42 10 10 10 10 10 10 10 10 10 10 10 11 10 10 11 10 10 11 10 10 10 10 11 10 42 42 42 10 10 10 10 10 10 10 10 10 42 42
42 42 42 42 10 11 10 10 10 10 11 10 10 10 11 10 10 10 10 10 10 10 10 11 10 10 10 10 10 10 10 10 10 10 10 10 42 42 42 10 10 10 10 10 10 10 10 10 42 42
42 42 42 42 10 10 10 10 10 10 10 10 10 10 10 10 10 10 10 10 10 10 10 10 10 10 10 10 10 11 10 11 10 10 10 10 42 42 42 42 42 42 42 42 42 10 42 42 42 42
42 42 42 42 10 10 10 10 10 10 10 10 10 10 10 10 10 10 10 10 10 10 10 10 10 10 10 10 10 10 10 10 10 10 10 10 42 42 42 42 42 42 42 10 10 10 10 10 42 42
42 42 42 42 10 11 10 10 11 10 10 10 10 10 10 10 10 10 10 10 10 10 10 10 10 10 10 10 10 10 10 10 10 10 10 10 10 10 10 10 10 10 10 10 10 10 10 10 42 42
42 42 42 42 10 10 10 10 10 10 10 10 10 10 11 10 10 10 10 10 10 10 10 10 10 10 10 10 10 10 10 10 10 10 10 10 10 10 10 10 10 10 10 10 10 10 10 10 42 42
42 42 42 42 10 10 10 10 10 10 10 10 10 10 10 10 10 10 10 10 10 10 42 42 42 42 42 42 42 42 42 42 42 42 10 10 10 10 10 10 10 10 10 10 10 10 10 10 42 42
42 42 42 42 10 10 10 10 10 10 10 10 10 10 10 10 10 10 10 10 10 42 42 42 42 42 42 10 10 10 10 10 10 10 10 10 10 10 10 10 10 10 10 10 10 10 10 10 42 42
42 42 42 42 10 10 10 10 11 10 11 10 10 10 10 10 10 10 10 10 42 42 42 42 42 42 42 42 42 42 42 42 10 10 10 10 10 10 10 10 10 10 10 10 10 10 10 10 42 42
42 42 42 42 10 10 10 10 10 10 10 10 10 10 10 10 11 10 10 10 42 42 42 42 42 42 42 42 42 42 42 42 10 10 10 10 10 10 10 10 10 10 10 10 10 10 10 10 42 42
42 42 42 42 10 10 10 10 10 10 10 10 10 10 10 10 10 10 42 10 10 10 10 10 10 10 42 42 42 42 42 42 10 10 10 10 10 10 10 10 10 10 10 10 10 10 10 10 42 42
42 42 42 42 10 10 10 11 10 10 10 10 10 10 10 10 10 10 10 10 10 10 10 10 10 10 10 10 10 42 42 42 42 42 42 10 10 10 10 10 10 10 10 10 10 10 10 10 42 42
42 42 42 42 10 10 10 10 10 10 10 10 10 10 10 10 10 10 10 10 10 10 10 10 10 10 10 10 10 10 10 10 10 10 10 10 10 10 10 10 10 10 10 10 10 10 10 10 42 42
42 42 42 42 10 10 10 10 10 10 10 10 10 10 10 11 10 10 10 10 10 42 10 10 10 10 10 10 10 10 10 10 10 10 10 10 10 10 10 10 10 10 10 10 10 10 10 10 42 42
42 42 42 42 10 10 10 10 10 10 10 10 10 10 42 11 42 42 42 42 42 10 42 42 10 10 10 10 10 10 10 10 10 10 10 10 10 10 10 10 10 10 10 10 10 10 10 10 42 42
42 42 42 42 10 10 10 10 10 10 10 10 10 10 10 10 11 10 42 10 10 10 10 10 10 10 10 10 10 10 10 10 10 10 10 10 10 10 10 10 10 10 10 10 10 10 10 10 42 42
42 42 42 42 10 10 10 11 10 10 10 10 10 10 10 10 42 10 10 10 10 10 10 10 10 10 10 10 10 10 10 10 10 10 10 10 10 10 10 10 10 10 10 10 10 10 10 10 42 42
42 42 42 42 10 10 10 10 10 10 10 10 10 10 10 10 11 10 10 10 10 10 10 10 10 10 10 10 10 10 10 10 10 10 10 10 10 10 10 10 10 10 10 10 10 10 10 10 42 42
42 42 42 42 10 10 10 10 11 10 10 10 10 10 10 10 10 10 10 10 10 10 10 10 10 11 10 10 10 10 10 10 10 10 10 10 10 10 10 10 10 10 10 10 10 10 10 10 42 42
42 42 42 42 10 10 10 10 10 10 10 10 10 10 10 10 10 10 10 10 10 10 10 10 10 10 10 10 10 11 10 10 10 10 10 10 10 10 10 10 10 10 10 10 10 10 10 10 42 42
42 42 42 42 10 10 10 10 10 10 10 10 10 10 10 10 10 10 10 10 10 10 10 10 10 10 10 10 10 10 10 10 10 10 10 10 10 10 10 10 10 10 10 10 10 10 10 10 42 42
42 42 10 10 10 42 42 42 42 42 42 10 42 42 42 10 10 10 10 10 10 10 10 10 10 10 10 10 10 10 10 10 10 10 10 10 10 10 10 10 10 10 10 10 10 10 10 10 42 42
42 42 10 10 10 10 42 42 42 42 42 42 42 42 42 10 10 10 10 10 10 10 10 10 10 10 10 10 42 42 42 42 42 42 42 42 42 42 42 10 10 10 10 10 10 10 10 10 42 42
42 42 10 10 10 10 42 42 42 10 10 10 42 42 42 42 42 42 42 42 10 10 10 10 10 10 10 10 10 10 10 10 10 42 42 42 42 42 42 42 42 42 42 10 10 10 10 10 42 42
42 42 10 10 10 10 42 42 42 10 10 10 10 10 10 10 10 10 10 10 10 10 10 10 10 11 10 10 10 10 10 10 10 10 42 42 42 42 42 42 42 42 42 42 10 10 10 10 42 42
42 42 10 10 10 10 42 42 42 10 10 10 10 10 10 10 11 10 10 10 10 10 10 10 10 10 10 10 11 10 11 10 10 42 42 42 42 42 42 42 42 42 42 10 10 10 10 10 42 42
42 42 10 11 10 10 42 42 42 42 42 42 10 10 10 10 10 42 42 10 10 10 10 10 10 10 10 10 10 10 10 10 10 10 10 10 10 10 10 11 10 10 10 10 10 11 10 10 42 42
42 42 10 10 10 10 42 42 42 42 42 42 10 10 10 10 10 42 42 10 10 10 10 10 10 10 10 10 10 10 10 10 10 10 10 10 10 10 10 10 10 10 10 10 10 10 10 10 42 42
42 42 10 10 10 10 10 10 10 42 42 42 10 10 10 10 10 10 42 42 10 10 10 10 10 10 10 10 10 10 10 10 10 10 10 11 10 10 10 10 11 10 10 10 10 10 10 10 42 42
42 42 10 10 11 10 10 10 10 42 42 42 10 10 11 10 10 10 10 42 42 10 10 10 10 10 10 10 11 10 10 10 10 10 10 10 10 10 10 11 10 10 11 10 10 11 10 10 42 42
42 42 10 10 10 10 10 10 10 42 42 42 10 10 10 10 11 10 10 42 42 10 10 10 10 11 10 10 10 10 11 10 10 10 10 10 10 10 10 10 10 10 10 10 10 10 10 10 42 42
42 42 42 42 42 42 42 11 10 42 42 42 10 10 10 10 10 10 10 42 42 10 10 10 10 10 10 10 10 10 10 10 10 10 10 10 10 10 10 10 10 10 10 10 10 10 10 10 42 42
42 42 42 42 42 42 42 10 10 42 42 42 10 10 10 10 10 10 10 10 42 42 42 42 42 42 42 42 42 42 42 42 42 42 42 42 42 42 42 42 42 42 42 42 42 42 42 42 42 42
42 42 10 10 10 10 10 10 10 42 42 42 10 11 10 10 10 10 10 10 42 42 42 42 42 42 42 42 42 42 42 42 42 42 42 42 42 42 42 42 42 42 42 42 42 42 42 42 42 42
42 42 10 10 10 10 10 10 10 42 42 42 10 10 10 10 10 10 10 10 42 42 42 42 42 42 42 42 42 42 42 42 42 42 42 42 42 42 42 42 42 42 42 42 42 42 42 42 42 42
42 42 42 42 42 42 42 42 42 42 42 42 42 42 42 42 42 42 42 42 42 42 42 42 42 42 42 42 42 42 42 42 42 42 42 42 42 42 42 42 42 42 42 42 42 42 42 42 42 42
42 42 42 42 42 42 42 42 42 42 42 42 42 42 42 42 42 42 42 42 42 42 42 42 42 42 42 42 42 42 42 42 42 42 42 42 42 42 42 42 42 42 42 42 42 42 42 42 42 42
42 42 42 42 42 42 42 42 42 42 42 42 42 42 42 42 42 42 42 42 42 42 42 42 42 42 42 42 42 42 42 42 42 42 42 42 42 42 42 42 42 42 42 42 42 42 42 42 42 42
42 42 42 42 42 42 42 42 42 42 42 42 42 42 42 42 42 42 42 42 42 42 42 42 42 42 42 42 42 42 42 42 42 42 42 42 42 42 42 42 42 42 42 42 42 42 42 42 42 42
42 42 42 42 42 42 42 42 42 42 42 42 42 42 42 42 42 42 42 42 42 42 42 42 42 42 42 42 42 42 42 42 42 42 42 42 42 42 42 42 42 42 42 42 42 42 42 42 42 42
42 42 42 42 42 42 42 42 42 42 42 42 42 42 42 42 42 42 42 42 42 42 42 42 42 42 42 42 42 42 42 42 42 42 42 42 42 42 42 42 42 42 42 42 42 42 42 42 42 42
42 42 42 42 42 42 42 42 42 42 42 42 42 42 42 42 42 42 42 42 42 42 42 42 42 42 42 42 42 42 42 42 42 42 42 42 42 42 42 42 42 42 42 42 42 42 42 42 42 42